###########
#.#...###.#
#.#.#.....#
#...##.##.#
#####..##.#
#.##.S###.#
#......####
###.##.####
###.##.#.F#
#.#.#..#..#
#.#.##.#..#
#...#.....#
###########